++++++++++++++++++++++
+   +   ++ ++        +
+     +       +++++ ++
+ +    ++  ++++ +++ ++
+ +   + + ++    +++  +
+          ++  ++  + +
+++++ + +      ++  + +
+++++ +++  + +  ++   +
+          + + S+ +   
+++++ +  + + +     + +
++++++++++++++++++++++
